9
9
3,8,8,4,8,4,9,11,6,
16,11,11,16,31,16,11,11,16,
16,11,11,23,8,25,11,11,16,
26,29,29,29,29,29,29,29,26,
11,29,29,29,30,29,29,29,11,
6,29,29,29,29,29,29,29,6,
16,29,29,29,29,29,29,29,16,
16,27,27,27,27,27,27,27,16,
23,8,8,8,8,8,9,11,26,
